1111011111111
1010000000C01
1000011111001
1P00110000E01
1111111111111