11111111111111
1P0000000000C1
10111011111001
100000100000C1
11111110111111
1C100000E00001
11111111111111