111111111111111111111111111111111111111111111111
1P00000000000000000000000000000000000000000000C1
101111111111101111111011111110111111111111111101
100000000000100000000100000010000000000000000001
111101111110111110111101111010111111101111111101
1C00000000000C000000000000000000000000C000000E11
111111101111111011111111111101111111111111111101
100000100000000100000000000100000000000000000001
101110101111111011111111111101111111111111111101
10001000000000000000000000000000C000000000000001
101011111111111111111111111111111111111111111101
100C00000000000000000000000000000000000000000001
111111101111101111101011111111111111111111111101
100000100000100000100000000000000000000000000001
101110111110101111101111111011111111111111111101
100000000000100000000000000C00C00000000000000001
111101111110111110111101111010111111101111111101
1C0000000000000000000000000000000000000C00000011
111111111111111111111111111111111111111111111111
