1111111111111111111111111111111111111111
1P000000000000000000000000000000000000C1
1011111111111011111110111111011111111101
1000000000001000000001000001000000000001
1111011111101111101111011101010111111101
1C00000000000C00000000000000000C00000E11
1111111011111110111111111110111111111101
1000001000000001000000000010000000000001
1011101011111110111111111110111111111101
1000100000000000000000000C00000000000001
1010111111111111111111111111111111111101
100C000000000000000000000000000000000001
1111111011111011111010111111111111111101
1000001000001000001000000000000000000001
1011101111101011111011111101111111111101
100000000000100000000C00C000000000000001
1111011111101111101111011101011110111101
1C000000000000000000000000000000C0000011
1111111111111111111111111111111111111111
