11111111111111111111111111111
100000000000C10000000000001P1
10111111111101011101111110101
101C0001000101010000000100101
101111011111010101111101C0101
101C0000000000010100010111101
101111111111111101C101000C101
10000000000000010111010111101
11111111111111010000010000001
1C000000000001011111111111101
101110000000010000000001C0101
101C1110111001011100000110101
101000101C100100C111110000101
10111010101001110000010111101
1000101010100001000001011C101
1C001010101011011111000100101
11101000101000C00001010101101
100010C110111111000101010C101
10111011001100000001010101101
10100010011001110000000100001
101011100000C1C11110000101101
10101C11111111000000111101C01
1E1C100000000001000000C1C1001
11111111111111111111111111111