111111111111111111111111111111111111111111111111111111111111111111111111111111111111111111111111111111111111111111111111
100000000000000000000000011111111111111111111111111100000001111111111111111111111111111111111111111111111111111111111111
100000000C000000000000000000000P1110000000000000000000000001111111111111111111111111111111111111111111111111111111111111
1111111111111111110000000000000000000000000000000C0000000001111111111111111111111111111111111111111111111111111111111111
100000000000000000000000000000000000000000000000000000000000000000000000000000000000000000000000000000000000000000001111
100000000000000000011111111111111111111111111100000000000001111111111111111111111111111111111111111111111111111011111111
100000000000000000000000000000000000000000000000000000000001111111111111111111111111111111111111111111111111111011111111
100000000000000000000000000011111111111111111111111000000001111111111111111111111111111111111111111111111111111011111111
1000000000000000000000000000000000000C0000000000000000000001111111111111111111111111111111111111111111111111111011111111
100000000000000000000000000000000000000000000000000000000101000000000000000000000000000000000000000000000000000000111111
10000000000C000000000000000000000000000000000000000000000001111111111111111111111111111111111111111111111111111111111111
1111111111111111111111111111100000000000000000C1000000000001111111111111111111111111111111111111111111111111111111111111
100000000000000000000000000011100000000000000000000000000001111111111111111111111111111111111111111111111111111111111111
10111111111000000000011111111E111111100000000000000000010001111111111111111111111111111111111111111111111111111111111111
100000000010111111111000010000000000100000000000000000000001111111111111111111111111111111111111111111111111111111111111
100000000010000000001000011111000001111111111111111011111110000000000000000000000000000000000000000000000000000000111111
10000000001000C00000100001000000C000000000000000000000000001111111111111111111111111111111111111111111111111111111111111
101110000011111111111000010000000000000000000000000000000001111111111111111111111111111111111111111111111111111111111111
100000000000000011111100010000000000000000011110000000000001111111111111111111111111111111111111111111111111111111111111
100000000000000000000110111111111111111111110000000000000001111111111111111111111111111111111111111111111111111111111111
100000000000000000000000000000000000000000000000111111110001111111111111111111111111111111111111111111111111111111111111
111111111000001111111111111111111000000000001000100000011111111111111111111111111111111111111111111111111111111111111111
1000001C000000100000000000000100000000000000000010000100C001111111111111111111111111111111111111111111111111111111111111
100000111111111000000000000000000000000000000000000001101001111111111111111111111111111111111111111111111111111111111111
111111111111111111111111111111111111111111111111111111111111111111111111111111111111111111111111111111111111111111111111